NO ./textures/pika.xpm
SO ./textures/greystone.xpm
WE ./textures/purplestone.xpm
EA ./textures/red.xpm

F 255,204,204
C 255,178,102

1111111111
1001000001
1010010001
1100N00001
1000000001
1000000001
1111111111
