NO ./textures/pika.xpm
SO ./textures/greystone.xpm
WE ./textures/purplestone.xpm
EA ./textures/red.xpm

F 86,123,70
C 132,106,235

1111111111111111111111111
1 10000000001100000000001
1111000001110000000000001
10010000000000000000000011
1111101100000111000000000111
10000011000001110111110011111
1111111111011100000010001    
1111111111011101010010001    
1000110101011100000010001    
1000000000001100000010001    
1000000000001101010010N01    
100111010101111101111000111  
1111 1110101 101111010001    
1111 1111111 111111111111    
 