NO ./textures/eagle.xpm
SO ./textures/greystone.xpm
WE ./textures/purplestone.xpm
EA ./textures/red.xpm

F 255,204,204
C 255,178,102

1111111111
1000000001
10M0000001
1000S00001
1000000001
1000000001
1000000001
10000Z0001
1000000001
1000000001
1000000001
1111111111
