NO ./textures/pika.xpm
SO ./textures/greystone.xpm
WE ./textures/purplestone.xpm
EA ./textures/red.xpm
F 86,123,70
C 132,106,235
     11111111111111111111111
   11111001110000111111
11110011000101001111001
11000000000000W000000111
100000100000000001000011
111100000000010000000111
11111111000000000000011111
11111111111111111111111111111
