NO ./textures/spider_all.xpm
SO ./textures/spider_all.xpm
WE ./textures/spider_left.xpm
EA ./textures/spider_right.xpm

F 86,125,70
C 132,106,235

1111111111
1001000001
1010Z1C1O1
110M000001
10000000Z1
1000N00001
1111111111
