NO ./textures/eagle.xpm
SO ./textures/greystone.xpm
WE ./textures/purplestone.xpm
EA ./textures/red.xpm

F 86,123,70
C 132,106,235

        1111111        11111111111
        1000001        10000000M1
        1011001111111111000000001
        100100000CZC0000000000001
111111111011000001110000000000001
10000000001100000111C11111C111111
11110111111111C11100000010001
11110111111111Z111Z101001Z0M1
11ZC0000110101011100000010001
1M0C0000000000001100000010001
1M0C00000000000011M1010010001
11ZC00011101C1C11111011110N0111
11110111 111M1Z1 10111CZC00M1
11111111 1111111 111111111111
