NO ./textures/eagle.xpm
SO ./textures/greystone.xpm
WE ./textures/purplestone.xpm
EA ./textures/red.xpm

F 86,123,70
C 132,106,235

     11111111111111111111111
   11111001110000111111
11110011000101CC1111M01
110000CZ0000000000000111
100000100000000W01000011
111100Z000000Z000000111
11111111000000000000011111
11111111111111111111111111111
