NO ./textures/mario4k.xpm
SO ./textures/mario4k.xpm
WE ./textures/mario4k.xpm
EA ./textures/mario4k.xpm

F 86,123,70
C 132,106,235

        111111111111111111
        1000001100000000111111111
        1011001111111111000000001
        1001000000000000000000001
111111111011000001110000000000001
10000000001100000111011111C111111
11110111111111011100000010001
1111011111111101110101001M0Z1
11000000110101011100000010001
10000000000000001100000010001
10000000000000001101010010001
11000001110101011111011110N0111
11110111111010111111101000111
11111111 1111111 111111111111
