NO ./textures/eagle.xpm
SO ./textures/greystone.xpm
WE ./textures/purplestone.xpm
EA ./textures/red.xpm

F 86,123,70
C 132,106,235

        1111111        11111111111
        1000001        1000000001
        1011001111111111000000001
        100100000CZC0000000000001
111111111011000001110000000000001
10000000001100000111C11111C111111
11110111111111011100000010001
1111011111111101110101001Z0M1
11000000110101011100000010001
10000000000000001100000010001
10000000000000001101010010001
11000001110101011111011110N0111
11110111 1110101 10111CZC00M1
11111111 1111111 111111111111
