NO ./textures/pika.xpm
SO ./textures/greystone.xpm
WE ./textures/purplestone.xpm
EA ./textures/red.xpm

F 86,123,70
C 132,106,235

11111111111111111111111111111111111
10000000000000000000000000000000001
10000000000000000000000000000000001
10000000000000000000011111000000001
10000000001000000000000000000000001
10000000000000000000000000000000001
10000000000000000000000000000000001
11111110000000000000000000000000001
1000000000000000W000000000000000001
10000000000000000000000100000000001
10000000000000000000000000000000001
10000000000001111110000000000000001
10000000000000000000000000000000001
10011111111111111111111111111110001
10000000000000000000000000000000001
10000000000000000000000000000000001
10000000000000000000000000000000001
10000000000000000000000000000000001
11111111111111111111111111111111111
